interval_start,interval_end,host_ip,total_packets,incoming_packets,outgoing_packets,unique_src_ips,unique_dst_ports,total_packets_size
2025-07-31 22:00:00.319387,2025-07-31 22:30:00.319387,172.27.164.13,330,106,224,9,5,1378
2025-07-31 22:00:00.319387,2025-07-31 22:30:00.319387,172.31.112.49,347,274,73,1,1,238
2025-07-31 22:00:00.319387,2025-07-31 22:30:00.319387,10.64.128.26,62,38,24,6,18,8920
2025-07-31 22:00:00.319387,2025-07-31 22:30:00.319387,192.168.133.244,63,62,1,19,4,7630
2025-07-31 22:00:00.319387,2025-07-31 22:30:00.319387,192.168.152.113,449,405,44,20,14,5306
2025-07-31 22:30:00.319387,2025-07-31 23:00:00.319387,172.27.164.13,157,66,91,18,2,12648
2025-07-31 22:30:00.319387,2025-07-31 23:00:00.319387,172.31.112.49,319,225,94,16,18,13617
2025-07-31 22:30:00.319387,2025-07-31 23:00:00.319387,10.64.128.26,351,15,336,13,15,6582
2025-07-31 22:30:00.319387,2025-07-31 23:00:00.319387,192.168.133.244,73,27,46,3,12,14697
2025-07-31 22:30:00.319387,2025-07-31 23:00:00.319387,192.168.152.113,47,1,46,2,10,10664
2025-07-31 23:00:00.319387,2025-07-31 23:30:00.319387,172.27.164.13,196,118,78,9,8,9527
2025-07-31 23:00:00.319387,2025-07-31 23:30:00.319387,172.31.112.49,192,159,33,5,3,5610
2025-07-31 23:00:00.319387,2025-07-31 23:30:00.319387,10.64.128.26,428,9,419,7,14,6168
2025-07-31 23:00:00.319387,2025-07-31 23:30:00.319387,192.168.133.244,237,153,84,11,0,14503
2025-07-31 23:00:00.319387,2025-07-31 23:30:00.319387,192.168.152.113,56,48,8,8,4,12876
2025-07-31 23:30:00.319387,2025-08-01 00:00:00.319387,172.27.164.13,132,31,101,14,12,7319
2025-07-31 23:30:00.319387,2025-08-01 00:00:00.319387,172.31.112.49,214,135,79,4,8,391
2025-07-31 23:30:00.319387,2025-08-01 00:00:00.319387,10.64.128.26,121,72,49,4,14,10891
2025-07-31 23:30:00.319387,2025-08-01 00:00:00.319387,192.168.133.244,166,37,129,4,7,9221
2025-07-31 23:30:00.319387,2025-08-01 00:00:00.319387,192.168.152.113,233,137,96,14,10,8721
2025-08-01 00:00:00.319387,2025-08-01 00:30:00.319387,172.27.164.13,245,84,161,15,10,208
2025-08-01 00:00:00.319387,2025-08-01 00:30:00.319387,172.31.112.49,136,6,130,4,5,977
2025-08-01 00:00:00.319387,2025-08-01 00:30:00.319387,10.64.128.26,109,8,101,8,15,9786
2025-08-01 00:00:00.319387,2025-08-01 00:30:00.319387,192.168.133.244,290,162,128,8,2,1399
2025-08-01 00:00:00.319387,2025-08-01 00:30:00.319387,192.168.152.113,276,41,235,11,3,3359
2025-08-01 00:30:00.319387,2025-08-01 01:00:00.319387,172.27.164.13,483,86,397,1,12,11191
2025-08-01 00:30:00.319387,2025-08-01 01:00:00.319387,172.31.112.49,486,208,278,1,2,11987
2025-08-01 00:30:00.319387,2025-08-01 01:00:00.319387,10.64.128.26,59,26,33,8,13,8778
2025-08-01 00:30:00.319387,2025-08-01 01:00:00.319387,192.168.133.244,422,106,316,20,15,12217
2025-08-01 00:30:00.319387,2025-08-01 01:00:00.319387,192.168.152.113,369,362,7,1,0,10606
2025-08-01 01:00:00.319387,2025-08-01 01:30:00.319387,172.27.164.13,353,257,96,5,16,2477
2025-08-01 01:00:00.319387,2025-08-01 01:30:00.319387,172.31.112.49,279,139,140,18,7,690
2025-08-01 01:00:00.319387,2025-08-01 01:30:00.319387,10.64.128.26,288,260,28,17,12,10973
2025-08-01 01:00:00.319387,2025-08-01 01:30:00.319387,192.168.133.244,429,425,4,14,0,549
2025-08-01 01:00:00.319387,2025-08-01 01:30:00.319387,192.168.152.113,188,48,140,1,5,4532
2025-08-01 01:30:00.319387,2025-08-01 02:00:00.319387,172.27.164.13,347,98,249,12,14,463
2025-08-01 01:30:00.319387,2025-08-01 02:00:00.319387,172.31.112.49,461,84,377,7,11,7939
2025-08-01 01:30:00.319387,2025-08-01 02:00:00.319387,10.64.128.26,373,20,353,12,15,13910
2025-08-01 01:30:00.319387,2025-08-01 02:00:00.319387,192.168.133.244,77,11,66,13,6,13246
2025-08-01 01:30:00.319387,2025-08-01 02:00:00.319387,192.168.152.113,29,0,29,6,13,2133
2025-08-01 02:00:00.319387,2025-08-01 02:30:00.319387,172.27.164.13,104,101,3,12,13,9542
2025-08-01 02:00:00.319387,2025-08-01 02:30:00.319387,172.31.112.49,392,291,101,7,1,7924
2025-08-01 02:00:00.319387,2025-08-01 02:30:00.319387,10.64.128.26,379,144,235,6,13,5891
2025-08-01 02:00:00.319387,2025-08-01 02:30:00.319387,192.168.133.244,306,237,69,6,4,14569
2025-08-01 02:00:00.319387,2025-08-01 02:30:00.319387,192.168.152.113,269,202,67,13,14,6233
2025-08-01 02:30:00.319387,2025-08-01 03:00:00.319387,172.27.164.13,84,50,34,12,14,13484
2025-08-01 02:30:00.319387,2025-08-01 03:00:00.319387,172.31.112.49,219,130,89,20,12,4694
2025-08-01 02:30:00.319387,2025-08-01 03:00:00.319387,10.64.128.26,5,4,1,12,18,7739
2025-08-01 02:30:00.319387,2025-08-01 03:00:00.319387,192.168.133.244,137,7,130,16,0,4878
2025-08-01 02:30:00.319387,2025-08-01 03:00:00.319387,192.168.152.113,235,36,199,18,9,10007
2025-08-01 03:00:00.319387,2025-08-01 03:30:00.319387,172.27.164.13,265,200,65,10,15,3585
2025-08-01 03:00:00.319387,2025-08-01 03:30:00.319387,172.31.112.49,364,138,226,1,20,13863
2025-08-01 03:00:00.319387,2025-08-01 03:30:00.319387,10.64.128.26,2,2,0,15,19,2644
2025-08-01 03:00:00.319387,2025-08-01 03:30:00.319387,192.168.133.244,245,142,103,19,11,522
2025-08-01 03:00:00.319387,2025-08-01 03:30:00.319387,192.168.152.113,8,7,1,9,0,12967
2025-08-01 03:30:00.319387,2025-08-01 04:00:00.319387,172.27.164.13,261,159,102,16,5,4343
2025-08-01 03:30:00.319387,2025-08-01 04:00:00.319387,172.31.112.49,73,40,33,2,4,2688
2025-08-01 03:30:00.319387,2025-08-01 04:00:00.319387,10.64.128.26,109,78,31,14,18,1326
2025-08-01 03:30:00.319387,2025-08-01 04:00:00.319387,192.168.133.244,187,138,49,7,12,4122
2025-08-01 03:30:00.319387,2025-08-01 04:00:00.319387,192.168.152.113,181,48,133,6,7,900
2025-08-01 04:00:00.319387,2025-08-01 04:30:00.319387,172.27.164.13,465,4,461,14,10,1254
2025-08-01 04:00:00.319387,2025-08-01 04:30:00.319387,172.31.112.49,61,59,2,20,5,11414
2025-08-01 04:00:00.319387,2025-08-01 04:30:00.319387,10.64.128.26,114,72,42,9,3,9465
2025-08-01 04:00:00.319387,2025-08-01 04:30:00.319387,192.168.133.244,448,31,417,14,3,6191
2025-08-01 04:00:00.319387,2025-08-01 04:30:00.319387,192.168.152.113,346,170,176,1,12,914
2025-08-01 04:30:00.319387,2025-08-01 05:00:00.319387,172.27.164.13,450,414,36,3,12,10352
2025-08-01 04:30:00.319387,2025-08-01 05:00:00.319387,172.31.112.49,308,105,203,9,10,7317
2025-08-01 04:30:00.319387,2025-08-01 05:00:00.319387,10.64.128.26,21,19,2,5,2,10355
2025-08-01 04:30:00.319387,2025-08-01 05:00:00.319387,192.168.133.244,179,87,92,3,2,3792
2025-08-01 04:30:00.319387,2025-08-01 05:00:00.319387,192.168.152.113,335,25,310,18,16,6066
2025-08-01 05:00:00.319387,2025-08-01 05:30:00.319387,172.27.164.13,403,200,203,12,5,8586
2025-08-01 05:00:00.319387,2025-08-01 05:30:00.319387,172.31.112.49,3,0,3,20,19,8772
2025-08-01 05:00:00.319387,2025-08-01 05:30:00.319387,10.64.128.26,314,309,5,20,13,12800
2025-08-01 05:00:00.319387,2025-08-01 05:30:00.319387,192.168.133.244,270,158,112,14,5,14051
2025-08-01 05:00:00.319387,2025-08-01 05:30:00.319387,192.168.152.113,479,320,159,19,20,12395
2025-08-01 05:30:00.319387,2025-08-01 06:00:00.319387,172.27.164.13,220,61,159,9,0,10216
2025-08-01 05:30:00.319387,2025-08-01 06:00:00.319387,172.31.112.49,152,79,73,11,14,2572
2025-08-01 05:30:00.319387,2025-08-01 06:00:00.319387,10.64.128.26,329,87,242,17,6,11233
2025-08-01 05:30:00.319387,2025-08-01 06:00:00.319387,192.168.133.244,446,209,237,5,2,10532
2025-08-01 05:30:00.319387,2025-08-01 06:00:00.319387,192.168.152.113,69,40,29,8,2,3681
2025-08-01 06:00:00.319387,2025-08-01 06:30:00.319387,172.27.164.13,459,315,144,6,7,13962
2025-08-01 06:00:00.319387,2025-08-01 06:30:00.319387,172.31.112.49,223,207,16,14,19,11151
2025-08-01 06:00:00.319387,2025-08-01 06:30:00.319387,10.64.128.26,392,248,144,16,1,4506
2025-08-01 06:00:00.319387,2025-08-01 06:30:00.319387,192.168.133.244,294,38,256,11,19,6168
2025-08-01 06:00:00.319387,2025-08-01 06:30:00.319387,192.168.152.113,18,2,16,3,8,10115
2025-08-01 06:30:00.319387,2025-08-01 07:00:00.319387,172.27.164.13,36,1,35,18,7,10599
2025-08-01 06:30:00.319387,2025-08-01 07:00:00.319387,172.31.112.49,338,229,109,12,16,10270
2025-08-01 06:30:00.319387,2025-08-01 07:00:00.319387,10.64.128.26,495,166,329,17,9,14377
2025-08-01 06:30:00.319387,2025-08-01 07:00:00.319387,192.168.133.244,411,178,233,12,2,11741
2025-08-01 06:30:00.319387,2025-08-01 07:00:00.319387,192.168.152.113,372,298,74,10,16,9272
2025-08-01 07:00:00.319387,2025-08-01 07:30:00.319387,172.27.164.13,20,10,10,17,7,2940
2025-08-01 07:00:00.319387,2025-08-01 07:30:00.319387,172.31.112.49,400,181,219,20,9,8152
2025-08-01 07:00:00.319387,2025-08-01 07:30:00.319387,10.64.128.26,93,91,2,10,1,8240
2025-08-01 07:00:00.319387,2025-08-01 07:30:00.319387,192.168.133.244,37,7,30,17,17,3936
2025-08-01 07:00:00.319387,2025-08-01 07:30:00.319387,192.168.152.113,64,50,14,17,3,1088
2025-08-01 07:30:00.319387,2025-08-01 08:00:00.319387,172.27.164.13,86,30,56,10,15,11139
2025-08-01 07:30:00.319387,2025-08-01 08:00:00.319387,172.31.112.49,409,221,188,19,20,10100
2025-08-01 07:30:00.319387,2025-08-01 08:00:00.319387,10.64.128.26,207,24,183,9,16,12621
2025-08-01 07:30:00.319387,2025-08-01 08:00:00.319387,192.168.133.244,233,77,156,17,3,13263
2025-08-01 07:30:00.319387,2025-08-01 08:00:00.319387,192.168.152.113,445,264,181,11,1,13124
2025-08-01 08:00:00.319387,2025-08-01 08:30:00.319387,172.27.164.13,342,212,130,2,6,796
2025-08-01 08:00:00.319387,2025-08-01 08:30:00.319387,172.31.112.49,481,276,205,3,5,8177
2025-08-01 08:00:00.319387,2025-08-01 08:30:00.319387,10.64.128.26,311,267,44,5,12,5950
2025-08-01 08:00:00.319387,2025-08-01 08:30:00.319387,192.168.133.244,480,201,279,18,17,221
2025-08-01 08:00:00.319387,2025-08-01 08:30:00.319387,192.168.152.113,461,81,380,9,13,10841
2025-08-01 08:30:00.319387,2025-08-01 09:00:00.319387,172.27.164.13,370,323,47,15,4,4668
2025-08-01 08:30:00.319387,2025-08-01 09:00:00.319387,172.31.112.49,303,135,168,13,3,5987
2025-08-01 08:30:00.319387,2025-08-01 09:00:00.319387,10.64.128.26,283,14,269,5,10,9996
2025-08-01 08:30:00.319387,2025-08-01 09:00:00.319387,192.168.133.244,37,24,13,11,1,6905
2025-08-01 08:30:00.319387,2025-08-01 09:00:00.319387,192.168.152.113,386,104,282,7,8,10833
2025-08-01 09:00:00.319387,2025-08-01 09:30:00.319387,172.27.164.13,353,140,213,17,6,10344
2025-08-01 09:00:00.319387,2025-08-01 09:30:00.319387,172.31.112.49,67,37,30,4,4,1577
2025-08-01 09:00:00.319387,2025-08-01 09:30:00.319387,10.64.128.26,440,1,439,1,2,3994
2025-08-01 09:00:00.319387,2025-08-01 09:30:00.319387,192.168.133.244,495,449,46,1,2,14668
2025-08-01 09:00:00.319387,2025-08-01 09:30:00.319387,192.168.152.113,109,66,43,10,17,12626
2025-08-01 09:30:00.319387,2025-08-01 10:00:00.319387,172.27.164.13,264,105,159,17,12,12662
2025-08-01 09:30:00.319387,2025-08-01 10:00:00.319387,172.31.112.49,103,9,94,6,7,8086
2025-08-01 09:30:00.319387,2025-08-01 10:00:00.319387,10.64.128.26,484,179,305,15,2,5316
2025-08-01 09:30:00.319387,2025-08-01 10:00:00.319387,192.168.133.244,289,182,107,5,6,1017
2025-08-01 09:30:00.319387,2025-08-01 10:00:00.319387,192.168.152.113,113,70,43,12,7,7346
2025-08-01 10:00:00.319387,2025-08-01 10:30:00.319387,172.27.164.13,262,149,113,10,17,13604
2025-08-01 10:00:00.319387,2025-08-01 10:30:00.319387,172.31.112.49,464,123,341,6,13,7192
2025-08-01 10:00:00.319387,2025-08-01 10:30:00.319387,10.64.128.26,279,47,232,9,6,6655
2025-08-01 10:00:00.319387,2025-08-01 10:30:00.319387,192.168.133.244,480,110,370,20,10,6463
2025-08-01 10:00:00.319387,2025-08-01 10:30:00.319387,192.168.152.113,331,7,324,16,10,7743
2025-08-01 10:30:00.319387,2025-08-01 11:00:00.319387,172.27.164.13,59,23,36,18,17,2412
2025-08-01 10:30:00.319387,2025-08-01 11:00:00.319387,172.31.112.49,122,89,33,12,18,14064
2025-08-01 10:30:00.319387,2025-08-01 11:00:00.319387,10.64.128.26,151,134,17,7,1,12731
2025-08-01 10:30:00.319387,2025-08-01 11:00:00.319387,192.168.133.244,333,268,65,14,12,2756
2025-08-01 10:30:00.319387,2025-08-01 11:00:00.319387,192.168.152.113,347,80,267,9,20,13197
2025-08-01 11:00:00.319387,2025-08-01 11:30:00.319387,172.27.164.13,149,59,90,8,15,5546
2025-08-01 11:00:00.319387,2025-08-01 11:30:00.319387,172.31.112.49,247,77,170,16,12,7119
2025-08-01 11:00:00.319387,2025-08-01 11:30:00.319387,10.64.128.26,417,74,343,19,16,7690
2025-08-01 11:00:00.319387,2025-08-01 11:30:00.319387,192.168.133.244,225,128,97,2,12,9183
2025-08-01 11:00:00.319387,2025-08-01 11:30:00.319387,192.168.152.113,49,11,38,6,1,4063
2025-08-01 11:30:00.319387,2025-08-01 12:00:00.319387,172.27.164.13,295,21,274,10,3,4348
2025-08-01 11:30:00.319387,2025-08-01 12:00:00.319387,172.31.112.49,407,292,115,19,0,8889
2025-08-01 11:30:00.319387,2025-08-01 12:00:00.319387,10.64.128.26,45,35,10,8,10,188
2025-08-01 11:30:00.319387,2025-08-01 12:00:00.319387,192.168.133.244,249,170,79,14,1,303
2025-08-01 11:30:00.319387,2025-08-01 12:00:00.319387,192.168.152.113,187,38,149,16,18,2932
2025-08-01 12:00:00.319387,2025-08-01 12:30:00.319387,172.27.164.13,449,224,225,17,20,9436
2025-08-01 12:00:00.319387,2025-08-01 12:30:00.319387,172.31.112.49,129,4,125,18,18,11251
2025-08-01 12:00:00.319387,2025-08-01 12:30:00.319387,10.64.128.26,193,13,180,9,20,11312
2025-08-01 12:00:00.319387,2025-08-01 12:30:00.319387,192.168.133.244,436,408,28,16,11,987
2025-08-01 12:00:00.319387,2025-08-01 12:30:00.319387,192.168.152.113,449,290,159,1,2,9619
2025-08-01 12:30:00.319387,2025-08-01 13:00:00.319387,172.27.164.13,125,52,73,9,17,14797
2025-08-01 12:30:00.319387,2025-08-01 13:00:00.319387,172.31.112.49,169,168,1,14,1,7674
2025-08-01 12:30:00.319387,2025-08-01 13:00:00.319387,10.64.128.26,417,184,233,3,7,994
2025-08-01 12:30:00.319387,2025-08-01 13:00:00.319387,192.168.133.244,52,15,37,20,18,13430
2025-08-01 12:30:00.319387,2025-08-01 13:00:00.319387,192.168.152.113,413,380,33,13,16,11668
2025-08-01 13:00:00.319387,2025-08-01 13:30:00.319387,172.27.164.13,433,242,191,17,14,9275
2025-08-01 13:00:00.319387,2025-08-01 13:30:00.319387,172.31.112.49,424,254,170,20,3,1201
2025-08-01 13:00:00.319387,2025-08-01 13:30:00.319387,10.64.128.26,231,127,104,6,1,5569
2025-08-01 13:00:00.319387,2025-08-01 13:30:00.319387,192.168.133.244,132,119,13,7,2,3140
2025-08-01 13:00:00.319387,2025-08-01 13:30:00.319387,192.168.152.113,413,392,21,8,7,12398
2025-08-01 13:30:00.319387,2025-08-01 14:00:00.319387,172.27.164.13,301,278,23,12,10,2953
2025-08-01 13:30:00.319387,2025-08-01 14:00:00.319387,172.31.112.49,45,8,37,4,9,11095
2025-08-01 13:30:00.319387,2025-08-01 14:00:00.319387,10.64.128.26,4,1,3,18,6,12874
2025-08-01 13:30:00.319387,2025-08-01 14:00:00.319387,192.168.133.244,368,131,237,16,17,4489
2025-08-01 13:30:00.319387,2025-08-01 14:00:00.319387,192.168.152.113,275,176,99,6,8,14041
2025-08-01 14:00:00.319387,2025-08-01 14:30:00.319387,172.27.164.13,285,262,23,10,7,5739
2025-08-01 14:00:00.319387,2025-08-01 14:30:00.319387,172.31.112.49,409,167,242,3,9,1169
2025-08-01 14:00:00.319387,2025-08-01 14:30:00.319387,10.64.128.26,182,145,37,15,15,12100
2025-08-01 14:00:00.319387,2025-08-01 14:30:00.319387,192.168.133.244,379,11,368,10,7,11625
2025-08-01 14:00:00.319387,2025-08-01 14:30:00.319387,192.168.152.113,238,96,142,17,14,11206
2025-08-01 14:30:00.319387,2025-08-01 15:00:00.319387,172.27.164.13,473,98,375,9,6,7066
2025-08-01 14:30:00.319387,2025-08-01 15:00:00.319387,172.31.112.49,390,197,193,7,10,10416
2025-08-01 14:30:00.319387,2025-08-01 15:00:00.319387,10.64.128.26,313,311,2,12,4,9183
2025-08-01 14:30:00.319387,2025-08-01 15:00:00.319387,192.168.133.244,461,432,29,18,17,11942
2025-08-01 14:30:00.319387,2025-08-01 15:00:00.319387,192.168.152.113,19,15,4,8,4,13777
2025-08-01 15:00:00.319387,2025-08-01 15:30:00.319387,172.27.164.13,439,66,373,19,6,7097
2025-08-01 15:00:00.319387,2025-08-01 15:30:00.319387,172.31.112.49,378,6,372,2,20,14464
2025-08-01 15:00:00.319387,2025-08-01 15:30:00.319387,10.64.128.26,264,62,202,12,16,5946
2025-08-01 15:00:00.319387,2025-08-01 15:30:00.319387,192.168.133.244,8,4,4,8,0,4870
2025-08-01 15:00:00.319387,2025-08-01 15:30:00.319387,192.168.152.113,272,187,85,14,6,500
2025-08-01 15:30:00.319387,2025-08-01 16:00:00.319387,172.27.164.13,280,104,176,6,9,5419
2025-08-01 15:30:00.319387,2025-08-01 16:00:00.319387,172.31.112.49,441,202,239,4,4,10393
2025-08-01 15:30:00.319387,2025-08-01 16:00:00.319387,10.64.128.26,96,0,96,16,1,9902
2025-08-01 15:30:00.319387,2025-08-01 16:00:00.319387,192.168.133.244,186,7,179,17,17,13860
2025-08-01 15:30:00.319387,2025-08-01 16:00:00.319387,192.168.152.113,11,7,4,17,10,13296
2025-08-01 16:00:00.319387,2025-08-01 16:30:00.319387,172.27.164.13,211,86,125,20,15,8072
2025-08-01 16:00:00.319387,2025-08-01 16:30:00.319387,172.31.112.49,442,251,191,6,2,1278
2025-08-01 16:00:00.319387,2025-08-01 16:30:00.319387,10.64.128.26,398,265,133,14,15,12455
2025-08-01 16:00:00.319387,2025-08-01 16:30:00.319387,192.168.133.244,193,124,69,17,0,3289
2025-08-01 16:00:00.319387,2025-08-01 16:30:00.319387,192.168.152.113,144,101,43,18,8,976
2025-08-01 16:30:00.319387,2025-08-01 17:00:00.319387,172.27.164.13,494,36,458,8,8,10838
2025-08-01 16:30:00.319387,2025-08-01 17:00:00.319387,172.31.112.49,496,65,431,20,14,6101
2025-08-01 16:30:00.319387,2025-08-01 17:00:00.319387,10.64.128.26,124,50,74,13,3,6814
2025-08-01 16:30:00.319387,2025-08-01 17:00:00.319387,192.168.133.244,288,249,39,1,10,6045
2025-08-01 16:30:00.319387,2025-08-01 17:00:00.319387,192.168.152.113,144,50,94,6,9,9878
2025-08-01 17:00:00.319387,2025-08-01 17:30:00.319387,172.27.164.13,118,108,10,13,11,3929
2025-08-01 17:00:00.319387,2025-08-01 17:30:00.319387,172.31.112.49,461,58,403,16,1,10591
2025-08-01 17:00:00.319387,2025-08-01 17:30:00.319387,10.64.128.26,474,323,151,12,0,3081
2025-08-01 17:00:00.319387,2025-08-01 17:30:00.319387,192.168.133.244,219,70,149,17,1,5296
2025-08-01 17:00:00.319387,2025-08-01 17:30:00.319387,192.168.152.113,265,96,169,6,6,2196
2025-08-01 17:30:00.319387,2025-08-01 18:00:00.319387,172.27.164.13,320,109,211,20,20,10315
2025-08-01 17:30:00.319387,2025-08-01 18:00:00.319387,172.31.112.49,402,317,85,6,12,9172
2025-08-01 17:30:00.319387,2025-08-01 18:00:00.319387,10.64.128.26,109,58,51,1,14,462
2025-08-01 17:30:00.319387,2025-08-01 18:00:00.319387,192.168.133.244,229,25,204,10,17,14114
2025-08-01 17:30:00.319387,2025-08-01 18:00:00.319387,192.168.152.113,499,499,0,17,20,644
2025-08-01 18:00:00.319387,2025-08-01 18:30:00.319387,172.27.164.13,165,7,158,2,14,5327
2025-08-01 18:00:00.319387,2025-08-01 18:30:00.319387,172.31.112.49,439,404,35,18,17,7564
2025-08-01 18:00:00.319387,2025-08-01 18:30:00.319387,10.64.128.26,436,348,88,8,8,11483
2025-08-01 18:00:00.319387,2025-08-01 18:30:00.319387,192.168.133.244,72,51,21,16,19,12764
2025-08-01 18:00:00.319387,2025-08-01 18:30:00.319387,192.168.152.113,19,6,13,6,6,10204
2025-08-01 18:30:00.319387,2025-08-01 19:00:00.319387,172.27.164.13,126,90,36,2,17,8339
2025-08-01 18:30:00.319387,2025-08-01 19:00:00.319387,172.31.112.49,197,20,177,9,10,9875
2025-08-01 18:30:00.319387,2025-08-01 19:00:00.319387,10.64.128.26,266,138,128,8,7,6830
2025-08-01 18:30:00.319387,2025-08-01 19:00:00.319387,192.168.133.244,139,17,122,9,18,11067
2025-08-01 18:30:00.319387,2025-08-01 19:00:00.319387,192.168.152.113,53,13,40,3,8,7814
2025-08-01 19:00:00.319387,2025-08-01 19:30:00.319387,172.27.164.13,263,36,227,11,6,14704
2025-08-01 19:00:00.319387,2025-08-01 19:30:00.319387,172.31.112.49,285,21,264,20,19,11961
2025-08-01 19:00:00.319387,2025-08-01 19:30:00.319387,10.64.128.26,278,10,268,3,3,14821
2025-08-01 19:00:00.319387,2025-08-01 19:30:00.319387,192.168.133.244,183,17,166,4,7,13322
2025-08-01 19:00:00.319387,2025-08-01 19:30:00.319387,192.168.152.113,40,34,6,5,8,8625
2025-08-01 19:30:00.319387,2025-08-01 20:00:00.319387,172.27.164.13,166,150,16,14,12,2283
2025-08-01 19:30:00.319387,2025-08-01 20:00:00.319387,172.31.112.49,126,50,76,17,18,4228
2025-08-01 19:30:00.319387,2025-08-01 20:00:00.319387,10.64.128.26,391,52,339,5,1,6367
2025-08-01 19:30:00.319387,2025-08-01 20:00:00.319387,192.168.133.244,24,11,13,12,20,11746
2025-08-01 19:30:00.319387,2025-08-01 20:00:00.319387,192.168.152.113,465,88,377,4,11,13524
2025-08-01 20:00:00.319387,2025-08-01 20:30:00.319387,172.27.164.13,426,26,400,7,19,9298
2025-08-01 20:00:00.319387,2025-08-01 20:30:00.319387,172.31.112.49,18,9,9,15,0,9726
2025-08-01 20:00:00.319387,2025-08-01 20:30:00.319387,10.64.128.26,330,131,199,14,1,5625
2025-08-01 20:00:00.319387,2025-08-01 20:30:00.319387,192.168.133.244,328,256,72,19,10,4912
2025-08-01 20:00:00.319387,2025-08-01 20:30:00.319387,192.168.152.113,304,3,301,12,18,14888
2025-08-01 20:30:00.319387,2025-08-01 21:00:00.319387,172.27.164.13,111,9,102,19,19,724
2025-08-01 20:30:00.319387,2025-08-01 21:00:00.319387,172.31.112.49,217,38,179,17,8,6712
2025-08-01 20:30:00.319387,2025-08-01 21:00:00.319387,10.64.128.26,175,27,148,7,19,13583
2025-08-01 20:30:00.319387,2025-08-01 21:00:00.319387,192.168.133.244,423,150,273,17,13,13412
2025-08-01 20:30:00.319387,2025-08-01 21:00:00.319387,192.168.152.113,285,38,247,11,17,4725
2025-08-01 21:00:00.319387,2025-08-01 21:30:00.319387,172.27.164.13,323,237,86,7,20,14610
2025-08-01 21:00:00.319387,2025-08-01 21:30:00.319387,172.31.112.49,365,33,332,2,16,4932
2025-08-01 21:00:00.319387,2025-08-01 21:30:00.319387,10.64.128.26,329,296,33,10,16,14910
2025-08-01 21:00:00.319387,2025-08-01 21:30:00.319387,192.168.133.244,159,117,42,13,8,1232
2025-08-01 21:00:00.319387,2025-08-01 21:30:00.319387,192.168.152.113,166,93,73,4,12,423
2025-08-01 21:30:00.319387,2025-08-01 22:00:00.319387,172.27.164.13,280,215,65,1,9,2878
2025-08-01 21:30:00.319387,2025-08-01 22:00:00.319387,172.31.112.49,432,27,405,12,15,8807
2025-08-01 21:30:00.319387,2025-08-01 22:00:00.319387,10.64.128.26,445,2,443,11,13,1963
2025-08-01 21:30:00.319387,2025-08-01 22:00:00.319387,192.168.133.244,295,17,278,7,1,978
2025-08-01 21:30:00.319387,2025-08-01 22:00:00.319387,192.168.152.113,193,162,31,9,2,753
